###############
#B ********* B#
# #*#*#*#*#*# #
#*************#
#*#*#*#*#*#*#*#
#*************#
#*#*#*#*#*#*#*#
#*************#
#*#*#*#*#*#*#*#
#*************#
#*#*#*#*#*#*#*#
#*************#
# #*#*#*#*#*# #
#B ********* B#
###############
